111111111111111
120100111111111
110101111111111
100000001111111
101101101111111
100100100001111
110001101100001
111110101101101
110000001101101
111111110001101
111111100111101
111111101000001
111111101111111
111111100000031
111111111111111