111111111111111
121000000000001
101011111111101
101000000000101
101111111110101
101000000000101
100001111111101
111101111011101
111101111011101
111100011011101
111111011011101
111111011011101
111111011011101
111111000000131
111111111111111