111111111111111
121111101111111
100111101111111
110111101100111
110111101110111
110000000110111
111110111110111
111110111110111
110000000000111
111101110110011
111101110111001
111100111111101
111110011110001
111111011111131
111111111111111