111111111111111
121000100000001
101011110111101
100000000000111
101111111110101
101000001000001
100001101111111
101101100011101
100101111011101
101100011000001
111101011011101
111001011011101
111111011111101
111111000000131
111111111111111